Diese Liste beinhaltet einen Teil der gegenwärtig registrierten 87 polnischen Parteien (Stand 2021), sowie die Parteilosen Selbstverwalter. Die aktuell im Sejm vertretenen Parteien sind fett gedruckt, wobei sich die Anzahl der jeweiligen Mandate im Artikel Sejm findet.


== Liste ==
BS: Parteilose Selbstverwalter (polnisch: Bezpartyjni Samorządowcy)
DB: Direkte Demokratie (pl: Demokracja Bezpośrednia)
iPL: Polnische Initiative (pl: Inicjatywa Polska)
KKP: Konföderation der polnischen Krone (pl: Konfederacja Korony Polskiej)
KNP: Kongress der neuen Rechten (pl: Kongres Nowej Prawicy)
Konfederacja: Konföderation der Freiheit und Unabhängigkeit (pl: Konfederacja Wolność i Niepodległość)
KORWiN: Koalition der Erneuerung der Republik Freiheit und Hoffnung (pl: Koalicja Odnowy Rzeczypospolitej Wolność i Nadzieja)
KPP: Kommunistische Partei Polens (pl: Komunistyczna Partia Polski)
KPEiR: Landesweite Partei der Pensionäre und Rentner (pl: Krajowa Partia Emerytów i Rencistów)
K’15: Kukiz-Bewegung (pl: Ruch Kukiza)
LPR: Liga polnischer Familien (pl: Liga Polskich Rodzin)
NOP: Nationale Wiedergeburt Polens (pl: Narodowe Odrodzenie Polski)
.N: Moderne (pl: Nowoczesna)
Piast: Partei Piast (pl: Stronnictwo Piast)
PiS: Recht und Gerechtigkeit (pl: Prawo i Sprawiedliwość)
PK: Partei der Kraftfahrer (pl: Partia Kierowców)
PL: Polnische Linke (pl: Polska Lewica)
PO: Bürgerplattform (pl: Platforma Obywatelska)
Porozumienie: Verständigung (pl: Porozumienie)
PPS: Polnische Sozialistische Partei (pl: Polska Partia Socjalistyczna)
PSL: Polnische Volkspartei (pl: Polskie Stronnictwo Ludowe)
Prawica RP: Die Rechte der Republik (pl: Prawica Rzeczypospolitej)
Razem: Linke Gemeinsam (pl: Lewica Razem)
RKN: Katholisch-Nationale Bewegung (pl: Ruch Katolicko-Narodowy)
RN: Nationale Bewegung (pl: Ruch Narodowy)
RPE: Bewegung echtes Europa - Europa Christi (pl: Ruch Prawdziwa Europa – Europa Christi)
Samoobrona: Selbstverteidigung (pl: Samoobrona)
SD: Demokratische Partei (pl: Stronnictwo Demokratyczne)
SDPL: Sozialdemokratie Polens (pl: Socjaldemokracja Polska)
Skuteczni: Die Wirksamen (pl: Skuteczni)
SLD: Neue Linke (pl: Nowa Lewica)
SP: Solidarisches Polen (pl: Solidarna Polska)
TR: Deine Bewegung (pl: Twój Ruch)
UED: Union der europäischen Demokraten (pl: Unia Europejskich Demokratów)
UPR: Union der Realpolitik (pl: Unia Polityki Realnej)
UP: Arbeitsunion (pl: Unia Pracy)
ZCHR: Vereinigung christlicher Familien (pl: Zjednoczenie Chrześcijańskich Rodzin)
Zieloni: Die Grünen (pl: Partia Zieloni)


== Weblinks ==


== Einzelnachweise ==